                   
 11111111 11111111 
 2  1   1 1   1  2 
 11111111111111111 
 1  1 1     1 1  1 
 1111 111 111 1111 
    1   0 0   1    
    1 0000000 1    
    1 0  4  0 1    
0000100 434 0010000
    1 0     0 1    
    1 0000000 1    
    1 0     0 1    
 11111111 11111111 
 1  1   1 1   1  1 
 21 11111511111 12 
  1 1 1     1 1 1  
 1111 111 111 1111 
 1      1 1      1 
 11111111111111111 
                   